########################
#@..............ac.G..b#
#.#d#e#f####.###########
#.#A#B#C####.####g.....#
#.#.#h#i##.......I######
###.#############.######
#...#..................#
########################