###############
#d.ABC.#.....a#
######...######
######.@.######
######...######
#b.....#.....c#
###############