#####
#...#
#E#S#
#...#
#####
