#############
#g#f.D#..h#l#
#F###e#E###.#
#dCba...BcIJ#
#####.@.#####
#nK.L...G...#
#M###N#H###.#
#o#m..#i#jk.#
#############