#######
#a.#Cd#
##...##
##.@.##
##...##
#cB#Ab#
#######