#############
#DcBa.#.GhKl#
#.###...#I###
#e#d#.@.#j#k#
###C#...###J#
#fEbA.#.FgHi#
#############