         A           
         A           
  #######.#########  
  #..####.........#  
  ##......#######.#  
  ##.####.......#.#  
  ##...##.#####.#.#  
  #####  B    #.#.#  
BC...##  C    #.#.#  
  ##.##       #.#.#  
  ##...DE  F  #.#.#  
  #####    G  #.#.#  
  ###.#####.###.#.#  
DE..#.....#...#.#.#  
  #.#.#######.###.#  
FG..#.............#  
  ###########.#####  
             Z       
             Z       
